NO ./wall.xpm
SO   ./wall1.xpm
        WE ./wall2.xpm
   EA ./wall.xpm

F 220,002,   255
C             225,       30, 210
        1111111111111111111111111
        1000000000110000000000001
    111110110000011100000001000011
    11101001000000000000000010001
111111000011000001110000000000001
100000000011000001110111111111111
11110111111111011100000010001
11110111111111011101010010001111
11000000110101011100000010001101
10000000000000001100000000001111
10000000000000001101010010001
11000001110101011111011110W0111
11110111 1110101 1011110100011111111111111111111
11111111 1111111 111111111111