NO ./wall.xpm
SO   ./wall1.xpm

F 220,100,   1

EA ./wall3.xpm
SO   ./wall1.xpm
WE                     ./wall2.xpm


C    225,       30, 210

        1111111111111111111111111



 
11111111 1111111 111111111111
121
111