NO ./wall.xpm
SO   ./wall1.xpm
EA ./wall3.xpm

F 220,100,   1
C    225,       30, 210

        1111111111111111111111111
        1000000000110000000000001
    11  10110000011100000001000011
    111 1001000000000000000010001
111111111011000001110000000000001
100000000011000001110111111111111
11110111111111011100000010001
11110111111111011101010010001
11000000110101011100000010001
10000000000000001100000000001
10000000000000001101010010001
11000001110101011111011110E0111
11110111 1110101 1011110100011111111111111111111
11111111 1111111 111111111111